/etc/X11/profile.d	setup
/etc/X11/wms-methods.d	xinitrc
/etc/X11/wmsession.d	xinitrc
/etc/X11/xinit.d	xinitrc
/etc/alternatives/packages.d	alternatives
/etc/chroot.d	chrooted
/etc/cron.d	vixie-cron
/etc/cron.daily	crontabs
/etc/cron.hourly	crontabs
/etc/cron.monthly	crontabs
/etc/cron.weekly	crontabs
/etc/emacs/site-start.d	emacs-base
/etc/hooks
/etc/logrotate.d	logrotate
/etc/pam.d	pam-config
/etc/ppp/ip-down.d	ppp-common
/etc/ppp/ip-up.d	ppp-common
/etc/rc.d/init.d	service
/etc/rpm/macros.d	rpm
/etc/security/console.apps	pam0_console
/etc/sudo.d	sudo
/etc/sudoers.d	sudo
/etc/sysconfig/limits.d	service
/etc/udev/rules.d	udev-rules
/etc/xinetd.d	xinetd
/lib/udev/rules.d	udev-rules
/lib64/udev	udev-rules
/lib64/udev/rules.d	udev-rules
/usr/lib/rpm/macros.d	rpm
